   s
  + +++++++
  + +     +
  + + +++ +
  +   +   +
  + + +++  f
  + +     +
  +++++++++
