
  +++++++++
 s        +
  +++++++ +
  +       +
  + +++++++
  +       +
  +++++++ +
  +       +
  + +++++++
  +       +
  +++++++ +
 f        +
  +++++++++
